*********************************
*...............................* 
*..*************..************..*
*......****...............****..*
*..**********************..***..*
*..**.....*********........***..*
*......*****...*..***..*******..*
*...............................*
*.**...**...****************..*.*
*.**...**........*********....*.*
*.**..*********...******.....**.*
*.**..*********...******...****.*
*.........*****..............**.*
*.****...***************...****.*
*...............................*
*********************************