****************  ***************
*                               *
*  *************  ************  *
*      ****               ****  *
*************************  ******
****      *********        ***  *
**     *****   *  ***  *******  *
*                               *
****   **   *********************
*      **        *********    ***
****  *********   ******     ****
***************   ******   ******
*         *****              ****
******   ***************   ******
******                          *
******************************  *