*********************************
*                               *
*  *************  ************  *
*      ****               ****  *
*  **********************  ***  *
*  **     *********        ***  *
**     *****   *  ***  *******  *
*                               *
****   **   ****************  ***
****   **        *********    ***
****  *********   ******     ****
****  *********   ******   ******
*         *****              ****
******   ***************   ******
******                          *
*********************************